###########################################################################################################################################################
#.........................................................................................................................................................#
#.........................................................................................................................................................#
#.........................................................................................................................................................#
#.........................................................................................................................................................#
#.........................................................................................................................................................#
#.........................................................................................................................................................#
#.........................................................................................................................................................#
#.........................................................................................................................................................#
#.........................................................................................................................................................#
#....................................___..................................................................................................................#
#.................................../   \.................................................................................................................#
#................................../     \................................................................................................................#
#................................./  ___  \...............................................................................................................#
#.................................|  | |  |...............................................................................................................#
#.................................|  | |  |...............................................................................................................#
#.................................|  ---  |...............................................................................................................#
#.................................|       |...............................................................................................................#
#.................................|       |...............................................................................................................#                                  
#.................................|  ___  |...............................................................................................................#
#.................................|  | |  |...............................................................................................................#
#................................/   | |   \..............................................................................................................#
#.............................../____| |____\.............................................................................................................#
#.........................................................................................................................................................#
#.........................................................................................................................................................#
#.........................................................................................................................................................#
#.........................................................................................................................................................#
#.........................................................................................................................................................#
#.........................................................................................................................................................#
#.........................................................................................................................................................#
#.........................................................................................................................................................#
#.........................................................................................................................................................#
#.........................................................................................................................................................#
#.........................................................................................................................................................#
#.........................................................................................................................................................#
#.........................................................................................................................................................#
#.........................................................................................................................................................#
#.........................................................................................................................................................#
..........................................................................................................................................................#
#.........................................................................................................................................................#
#.........................................................................................................................................................#
#.........................................................................................................................................................#
#.........................................................................................................................................................#
###########################################################################################################################################################