###########################################################################################################################################################
#.........................................................................................................................................................#
#.........................................................................................................................................................#
#.........................................................................................................................................................#
#.........................................................................................................................................................#
#.........................................................................................................................................................#
#.........................................................................................................................................................#
#.........................................................................................................................................................#
#.........................................................................................................................................................#
#.........................................................................................................................................................#
#.........................................................................................................................................................#
#.........................................................................................................................................................#
#.........................................................................................................................................................#
#.........................................................................................................................................................#
#.........................................................................................................................................................#
#.........................................................................................................................................................#
#.........................................................................................................................................................#
#.........................................................................................................................................................#
#.........................................................................................................................................................#
#.........................................................................................................................................................#
#.........................................................................................................................................................#
#.........................................................................................................................................................#
#.........................................................................................................................................................#
#.........................................................................................................................................................#
#.........................................................................................................................................................#
#.........................................................................................................................................................#
#.........................................................................................................................................................#
#.........................................................................................................................................................#
#.........................................................................................................................................................#
#.........................................................................................................................................................#
#.........................................................................................................................................................#
#.........................................................................................................................................................#
#.........................................................................................................................................................#
#.........................................................................................................................................................#
..........................................................................................................................................................#
#.........................................................................................................................................................#
#.........................................................................................................................................................#
#.........................................................................................................................................................#
#.........................................................................................................................................................#
###########################################################################################################################################################